
NO ./bonus/maps_bonus/no.xpm
SO ./bonus/maps_bonus/so.xpm
WE ./bonus/maps_bonus/we.xpm
EA ./bonus/maps_bonus/ea.xpm

F 88,17,17

C 135,206,250



1111
1N01
1001
1111