
NO ./path_to_the_north_texture
SO ./path_to_the_south_texture
WE ./path_to_the_west_texture
EA ./path_to_the_east_texture

F 88, 17, 17

C 135,206,250




        1111111111111111111111111
        1000000000110000000000001
        1011000001110000000000001
        1001000000000000000000001
111111111011000001110000000000001
100000000011000001110111110111111
11110111111111011100000010001
11110111111111011101010010001
1100000011010101110000001000111111111111111111
10000000001100000000000000000000000000000000001
10110000011100000000000010000000000000000000001
100100000000000000000000110000000000000000000001
10110000011100000000000010000000000000000000001
100100000000000000000000110000000000000000000001
101100000111000000000000100000000000000000000011
1001000000000000000000001110000000000000000000001
101100000111000000000000100000000000000000000011
100100000000000000000000110000000000000000000001
10110000011100000000000010000000000000000000001
100100000000000000000000110000000000000000000001
10110000011100000000000010000000000000000000001
100100000000000000000000110000000000000000000001
10110000011100000000000010000000000000000000001
100100000000000000000000110000000000000000000001
10110000011100000000000010000000000000000000001
100100000000000000000000110000000000000000000001
10110000011100000000000010000000000000000000001
10010000000000000000000010000000000000000000001111
100E01000000000011000000100010000000000000000000001
10001 1000000000110101001000100000000000000000000011
11000101110101001111011110001110000000000000000000001
11110111 1110101 1011110100010000000000000000000001
11111111 1111111 111111111111111111111111111111111