
NO ./maps/no.xpm
SO ./maps/so.xpm
WE ./maps/we.xpm
EA ./maps/ea.xpm

F 88, 17, 17

C 135,206,250



111111111111111111111111111111111111111111111111
111111111111111111111000011111111111111111111111
1E0000000000000001111000011111111100000000000011
100000000000000001111000000011111100000000000011
100000000000000001111000000000000000000000000011
100000000000000000000000000000000000000000000011
111111000000000000000000000011111100000000000011
     1000000000001111111111111111100000000000011
111111000000000001111111111111111111000000000011
100000000000000000000000000000000000000000000011
100000000000000000000000000000000000000000000011
100000000000000000011000000000000000000000000011
100000000000000000011000000000000000000000000011
111111111111111110011000111111111111100001111111
            1111000110001111       1100001111111
            11100011100001111     11100001111111
            110001111100001111    11100001111111
1111111111111000111111100001111   11100100111111
10000000000000011111111100001111 111000110011111
100000000000001111111111100001111111000111001111
100000001100001111111111100000000000001100000011
100000011000001111111111100000000000001100000011
100000110000000000000000000000000000001100000011
100000110000000000000000000000000000001100000011
100000110000000000000000000000000000001100000011
111111111111111111111111111111111111111111111111